SOOOOOOOOO
*O*OOO***O
*O*****O*O
*O*OOO*O*O
*O*O*O*O*O
*O*O*O***O
*O*O*OOO*O
*OOO*****O
*OO**O**OO
****OO***E