SOOOOOOOOO
*O*OOO*O*O
*O*****O*O
*O*OOO*O*O
***O*O*O*O
*O*O*O***O
*O*O*OOO*O
*OOO*****O
*OO*OO**OO
****O****E